{
  "name": "デバッグマップ",
  "stratum": [
    {
      "feild": [
        [ 1, 1, 1, 1, 1, 1, 1, 1, 1, 1],
        [ 1, 1, 1, 1, 1, 1, 1, 1, 1, 1],
        [ 1, 1, 1, 1, 1, 1, 1, 1, 1, 1],
        [ 1, 1, 1, 1, 1, 1, 1, 1, 1, 1],
        [ 1, 1, 1, 1, 1, 1, 1, 1, 1, 1],
        [ 1, 1, 1, 1, 1, 1, 1, 1, 1, 1],
        [ 2, 2, 2, 1, 1, 1, 1, 1, 2, 2],
        [ 2, 2, 2, 1, 1, 1, 1, 1, 2, 2],
        [ 2, 2, 2, 1,61, 1, 1, 1,61,61],
        [ 2, 2, 2, 1, 1, 1, 1, 1,61,61],
        [ 2, 2, 2, 1, 1, 1, 1, 1,61,61]
      ]
    },
    {
      "feild": [
        [ 0, 0, 0, 0, 0, 0, 0, 0, 0, 0],
        [ 0,50,51,51,51,51,51,51,52, 0],
        [ 0,33, 0, 0, 0, 0, 0, 0,35, 0],
        [ 0,33, 0, 0, 0, 0, 0, 0,35, 0],
        [ 0,33, 0, 0, 0, 0, 0, 0,35, 0],
        [ 0,33, 0, 0, 0, 0, 0, 0,35, 0],
        [ 0,36, 0, 0, 0, 0, 0, 0,38, 0],
        [ 0,22,41,41,41,23,40,23,24, 0],
        [ 0, 0, 0, 0, 0, 0, 0, 0, 0, 0],
        [ 0, 0, 0, 0, 0, 0, 0, 0, 0, 0],
        [ 0, 0, 0, 0, 0, 0, 0, 0, 0, 0]
      ]
    },
    {
      "feild": [
        [ 0, 0, 0, 0, 0, 0, 0, 0, 0, 0 ],
        [ 0, 0, 0, 0, 0, 0, 0, 0, 0, 0 ],
        [ 0, 0, 0, 0, 0, 0, 0, 0, 0, 0 ],
        [ 0, 0, 0, 0, 0, 0, 0, 0, 0, 0 ],
        [ 0, 0, 0, 0, 0, 0, 0, 0, 0, 0 ],
        [ 0, 0, 0, 0, 0, 0, 0, 0, 0, 0 ],
        [ 0, 0, 0, 0, 0, 0, 0, 0, 0, 0 ],
        [ 0, 0, 0, 0, 0, 0, 0, 0, 0, 0 ],
        [ 0, 0, 0, 0, 0, 0, 0, 0, 0, 0 ],
        [ 0, 0, 0, 0, 0, 0, 0, 0, 0, 0 ],
        [ 0, 0, 0, 0, 0, 0, 0, 0, 0, 0 ]
      ]
    },
    {
      "feild": [
        [ 0,50,51,51,51,51,51,51,52, 0],
        [ 0,33, 0, 0, 0, 0, 0, 0,35, 0],
        [ 0,33, 0, 0, 0, 0, 0, 0,35, 0],
        [ 0,33, 0, 0, 0, 0, 0, 0,35, 0],
        [ 0,33, 0, 0, 0, 0, 0, 0,35, 0],
        [ 0,36, 0, 0, 0, 0, 0, 0,38, 0],
        [ 0,39,41,41,41,20,20,20,21, 0],
        [ 0, 0, 0, 0, 0, 0, 0, 0, 0, 0],
        [ 0, 0, 0, 0, 0, 0, 0, 0, 0, 0],
        [ 0, 0, 0, 0, 0, 0, 0, 0, 0, 0],
        [ 0, 0, 0, 0, 0, 0, 0, 0, 0, 0]
      ]
    },
        {
      "feild": [
        [ 0,10,11,11,11,11,11,11,12, 0],
        [ 0,13, 3, 3, 3, 3, 3, 3,15, 0],
        [ 0,13, 3, 3, 3, 3, 3, 3,15, 0],
        [ 0,13, 3, 3, 3, 3, 3, 3,15, 0],
        [ 0,13, 3, 3, 3, 3, 3, 3,15, 0],
        [ 0,16, 3, 3, 3,17,17,17,18, 0],
        [ 0, 0, 0, 0, 0, 0, 0, 0, 0, 0],
        [ 0, 0, 0, 0, 0, 0, 0, 0, 0, 0],
        [ 0, 0, 0, 0, 0, 0, 0, 0, 0, 0],
        [ 0, 0, 0, 0, 0, 0, 0, 0, 0, 0],
        [ 0, 0, 0, 0, 0, 0, 0, 0, 0, 0]
      ]
    }
  ],
  "chip": {
    "1":  {"cell": "grass/grass1" },
    "2":  {"cell": "grass/grass2" },
    "3":  {"cell": "sand/soil0" },
    "10": {"cell": "sand/soil0" },
    "11": {"cell": "sand/soil0" },
    "12": {"cell": "sand/soil0" },
    "13": {"cell": "sand/soil0" },
    "15": {"cell": "sand/soil0" },
    "16": {"cell": "sand/soil0" },
    "17": {"cell": "sand/soil0" },
    "18": {"cell": "sand/soil0" },
    "30": {"cell": "cliff/cliff0" },
    "31": {"cell": "cliff/cliff1" },
    "32": {"cell": "cliff/cliff2" },
    "33": {"cell": "cliff/cliff4" },
    "35": {"cell": "cliff/cliff6" },
    "36": {"cell": "cliff/cliff8" },
    "37": {"cell": "cliff/cliff9" },
    "38": {"cell": "cliff/cliff10" },
    "39": {"cell": "cliff/cliff12" },
    "20": {"cell": "cliff/cliff13" },
    "21": {"cell": "cliff/cliff14" },
    "22": {"cell": "cliff/cliff16" },
    "23": {"cell": "cliff/cliff17" },
    "24": {"cell": "cliff/cliff18" },
    "40": {"cell": "cliff/cliff19" },
    "41": {"cell": "cliff/stairs" },
    "50": {"cell": "cliff/underCliff0" },
    "51": {"cell": "cliff/underCliff1" },
    "52": {"cell": "cliff/underCliff2" },
    "61": {"cell": "grass/grass1","encount": "grass" }
  },
  "ornament":[ 
  {"path": "sign/treeSign","name": "testSign","x": 0,"y": 1,"stratum": 0},
  {"path": "sign/treeSign","name": "testSign","x": 3,"y": 2,"stratum": 0}
  ],
  "npc": [
    {"path": "player/player","name": "test","direction": Vector2(-1,0),"ai": "<walkAroundCircle,1>","x":2,"y": 1,"stratum": 0}
  ],
  "trigger": [
    {"name": "test","shape": "<square,1,1>","x":3,"y": 4,"stratum": 2}
  ],
  "event": {
    
  }
}
