{
  "name": "デバッグマップ",
  "stratum": [
    {
      "feild": [
        [ 1, 1, 1, 1, 1, 1, 1, 1, 1, 1, 1, 1, 1, 1, 1, 1, 1, 1, 1 ],
        [ 1, 1, 1, 1, 1, 1, 1, 1, 1, 1, 1, 1, 1, 1, 1, 3, 1, 2, 1 ],
        [ 1, 1, 1, 1, 1, 1, 1, 3, 3, 3, 3, 2, 2, 2, 1, 3, 1, 2, 2 ],
        [ 1, 1, 1, 1, 1, 1, 1, 1, 1, 1, 1, 1, 1, 1, 1, 1, 1, 1, 1 ],
        [ 1, 1, 1, 1, 1, 1, 1, 1, 1, 1, 1, 1, 1, 1, 1, 1, 1, 1, 1 ],
        [ 3, 3, 3, 3, 3, 2, 3, 3, 2, 2, 1, 3, 3, 3, 3, 1, 3, 3, 2 ],
        [ 3, 1, 1, 3, 3, 2, 3, 3, 2, 2, 1, 3, 1, 2, 3, 1, 1, 2, 2 ],
        [ 3, 1, 3, 1, 3, 2, 3, 3, 3, 3, 1, 2, 1, 2, 2, 1, 1, 3, 3 ],
        [ 3, 1, 3, 1, 3, 2, 3, 3, 3, 3, 1, 1, 1, 2, 2, 1, 1, 3, 3 ],
        [ 1, 1, 1, 1, 1, 1, 1, 1, 1, 1, 1, 1, 1, 1, 1, 1, 1, 1, 1 ],
        [ 1, 1, 1, 1, 1, 1, 1, 1, 1, 1, 2, 2, 2, 2, 2, 1, 1, 1, 1 ],
        [ 1, 2, 1, 1, 1, 1, 1, 1, 1, 1, 2, 2, 1, 1, 2, 1, 1, 1, 1 ],
        [ 1, 1, 1, 1, 1, 1, 1, 1, 1, 1, 1, 1, 1, 1, 1, 1, 1, 1, 1 ],
        [ 1, 2, 2, 2, 1, 1, 1, 1, 2, 2, 2, 1, 1, 1, 1, 1, 1, 1, 1 ],
        [ 1, 1, 1, 1, 1, 1, 1, 1, 1, 2, 2, 1, 1, 1, 1, 1, 1, 1, 1 ],
        [ 1, 1, 1, 3, 1, 3, 1, 1, 1, 1, 1, 1, 1, 1, 1, 1, 1, 1, 1 ],
        [ 1, 1, 1, 1, 1, 3, 3, 1, 3, 1, 1, 1, 1, 1, 1, 1, 1, 1, 1 ],
        [ 1, 1, 1, 1, 1, 1, 1, 1, 1, 1, 1, 1, 3, 3, 3, 1, 1, 1, 1 ],
        [ 1, 1, 1, 1, 1, 1, 1, 1, 1, 1, 1, 3, 3, 3, 3, 1, 1, 1, 1 ],
        [ 1, 1, 4, 1, 1, 1, 1, 1, 1, 1, 1, 3, 1, 1, 1, 1, 1, 1, 1 ],
        [ 1, 6, 6, 1, 1, 1, 1, 1, 1, 1, 1, 1, 2, 2, 1, 1, 1, 1, 1 ],
        [ 1, 6, 6, 5, 5, 5, 1, 1, 1, 1, 1, 1, 1, 2, 2, 1, 1, 1, 1 ],
        [ 3, 3, 3, 3, 3, 4, 3, 3, 3, 3, 3, 3, 3, 2, 2, 3, 3, 3, 3 ],
        [ 2, 4, 2, 2, 2, 2, 2, 2, 2, 2, 2, 2, 2, 2, 2, 2, 2, 2, 2 ]
      ]
    },
    {
      "feild": [
        [ 0, 0, 0, 0, 0, 0, 0, 0, 0, 0, 0, 0, 0, 0, 0, 0, 0, 0, 0 ],
        [ 0, 0, 0, 0, 0, 0, 0, 0, 0, 0, 0, 0, 0, 0, 0, 0, 0, 0, 0 ],
        [ 0, 0, 0, 0, 0, 0, 0, 0, 0, 0, 0, 0, 0, 0, 0, 0, 0, 0, 0 ],
        [ 0, 0, 0, 0, 0, 0, 0, 0, 0, 0, 0, 0, 0, 0, 0, 0, 0, 0, 0 ],
        [ 0, 0, 0, 0, 0, 0, 0, 0, 0, 0, 0, 0, 0,30, 0, 0, 0, 0, 0 ],
        [ 0, 0, 0, 0, 0, 0, 0, 0, 0, 0, 0, 0, 0,31,11,14, 0, 0, 0 ],
        [ 0,13,42,15, 0, 0, 0,13,42,15, 0, 0, 0, 0, 0, 0, 0, 0, 0 ],
        [ 0, 0, 0, 0, 0, 0, 0, 0, 0, 0, 0, 0, 0, 0, 0,13,43,14,15 ],
        [ 0, 0, 0, 0, 0, 0, 0, 0, 0, 0, 0, 0, 0, 0, 0, 0, 0, 0, 0 ],
        [ 0, 0, 0, 0, 0, 0, 0, 0, 0, 0, 0, 0, 0, 0, 0, 0, 0, 0, 0 ],
        [ 0, 0, 0, 0, 0, 0, 0, 0, 0, 0,38,39, 0, 0, 0, 0, 0, 0, 0 ],
        [ 0, 0, 0, 0, 0, 0, 0, 0, 0, 0, 0, 0, 0, 0, 0, 0, 0, 0, 0 ],
        [ 0, 0, 0, 0, 0, 0, 0, 0, 0, 0, 0, 0, 0, 0, 0, 0, 0, 0, 0 ],
        [ 0, 0, 0, 0, 0,30, 0, 0, 0, 0, 0, 0, 0, 0, 0, 0, 0, 0, 0 ],
        [ 0, 0, 0, 0, 0,50, 0, 0, 0, 0, 0, 0, 0, 0, 0, 0, 0, 0, 0 ],
        [ 0, 0, 0, 0, 0,31, 0, 0, 0, 0, 0, 0, 0,34, 0, 0, 0, 0, 0 ],
        [ 0, 0, 0, 0, 0, 0, 0, 0, 0, 0, 0, 0, 0,35, 0, 0, 0, 0, 0 ],
        [13,42,15, 0, 0, 0, 0, 0, 0, 0, 0, 0, 0, 0, 0, 0, 0, 0, 0 ],
        [ 0, 0, 0, 0, 0, 0, 0, 0, 0, 0, 0, 0, 0, 0, 0, 0, 0, 0, 0 ],
        [ 0, 0, 0, 0, 0, 0,13,14,42,42,14,43,15, 0, 0, 0, 0, 0, 0 ],
        [ 0, 0, 0, 0, 0, 0, 0, 0, 0, 0, 0, 0, 0, 0, 0, 0, 0, 0, 0 ],
        [ 0, 0, 0, 0, 0, 0, 0, 0, 0, 0, 0, 0, 0, 0, 0, 0, 0, 0, 0 ],
        [ 0, 0, 0, 0, 0, 0, 0, 0, 0, 0, 0, 0, 0, 0, 0, 0, 0, 0, 0 ],
        [ 0, 0, 0, 0, 0, 0, 0, 0, 0, 0, 0, 0, 0, 0, 0, 0, 0, 0, 0 ]
      ]
    },
    {
      "feild": [
        [ 0, 0, 0, 0, 0, 0, 0, 0, 0, 0, 0, 0, 0, 0, 0, 0, 0, 0, 0 ],
        [ 0, 0, 0, 0, 0, 0, 0, 0, 0, 0, 0, 0, 0, 0, 0, 0, 0, 0, 0 ],
        [ 0, 0, 0, 0, 0, 0, 0, 0, 0, 0, 0, 0, 0, 0, 0, 0, 0, 0, 0 ],
        [ 0, 0, 0, 0, 0, 0, 0, 0, 0, 0, 0, 0, 0, 0, 0, 0, 0, 0, 0 ],
        [ 0, 0, 0, 0, 0, 0, 0, 0, 0, 0, 0, 0, 0, 0, 0, 0, 0, 0, 0 ],
        [ 0, 0, 0, 0, 0, 0, 0, 0, 0, 0, 0, 0, 0, 0, 0, 0, 0, 0, 0 ],
        [ 0, 0, 0, 0, 0, 0, 0, 0, 0, 0, 0, 0, 0, 0, 0, 0, 0, 0, 0 ],
        [ 0, 0, 0, 0, 0, 0, 0, 0, 0, 0, 0, 0, 0, 0, 0, 0, 0, 0, 0 ],
        [ 0, 0, 0, 0, 0, 0, 0, 0, 0, 0, 0, 0, 0, 0, 0, 0, 0, 0, 0 ],
        [ 0, 0, 0, 0, 0, 0, 0, 0, 0, 0, 0, 0, 0, 0, 0, 0, 0, 0, 0 ],
        [ 0, 0, 0, 0, 0, 0, 0, 0, 0, 0, 0, 0, 0, 0, 0, 0, 0, 0, 0 ],
        [ 0, 0, 0, 0, 0, 0,20,21,21,21,40,41,22, 0, 0, 0, 0, 0, 0 ],
        [ 0, 0, 0, 0, 0, 0,23, 5, 5, 5, 5, 5,25, 0, 0, 0, 0, 0, 0 ],
        [ 0, 0, 0, 0, 0, 0,32, 5, 5, 5, 5, 5,25, 0, 0, 0, 0, 0, 0 ],
        [ 0, 0, 0, 0, 0, 0, 9, 5, 5, 5, 5, 5,25, 0, 0, 0, 0, 0, 0 ],
        [ 0, 0, 0, 0, 0, 0,33, 5, 5, 5, 5, 5,36, 0, 0, 0, 0, 0, 0 ],
        [ 0, 0, 0, 0, 0, 0,23, 5, 5, 5, 5, 5,37, 0, 0, 0, 0, 0, 0 ],
        [ 0, 0, 0, 0, 0, 0,23, 5, 5, 5, 5, 5,25, 0, 0, 0, 0, 0, 0 ],
        [ 0, 0, 0, 0, 0, 0,26,27, 5, 5,27,27,28, 0, 0, 0, 0, 0, 0 ],
        [ 0, 0, 0, 0, 0, 0, 0, 0, 0, 0, 0, 0, 0, 0, 0, 0, 0, 0, 0 ],
        [ 0, 0, 0, 0, 0, 0, 0, 0, 0, 0, 0, 0, 0, 0, 0, 0, 0, 0, 0 ],
        [ 0, 0, 0, 0, 0, 0, 0, 0, 0, 0, 0, 0, 0, 0, 0, 0, 0, 0, 0 ],
        [ 0, 0, 0, 0, 0, 0, 0, 0, 0, 0, 0, 0, 0, 0, 0, 0, 0, 0, 0 ],
        [ 0, 0, 0, 0, 0, 0, 0, 0, 0, 0, 0, 0, 0, 0, 0, 0, 0, 0, 0 ]
      ]
    },
    {
      "feild": [
        [ 0, 0, 0, 0, 0, 0, 0, 0, 0, 0, 0, 0, 0, 0, 0, 0, 0, 0, 0 ],
        [ 0, 0, 0, 0, 0, 0, 0, 0, 0, 0, 0, 0, 0, 0, 0, 0, 0, 0, 0 ],
        [ 0, 0, 0, 0, 0, 0, 0, 0, 0, 0, 0, 0, 0, 0, 0, 0, 0, 0, 0 ],
        [ 0, 0, 0, 0, 0, 0, 0, 0, 0, 0, 0, 0, 0, 0,30, 0, 0, 0, 0 ],
        [ 0, 0, 0, 0, 0, 0, 0, 0, 0, 0, 0, 0, 0, 0,31, 0, 0, 0, 0 ],
        [ 0,10,42,12, 0, 0, 0,10,42,12, 0, 0, 0, 0, 0, 0, 0, 0, 0 ],
        [ 0, 0, 0, 0, 0, 0, 0, 0, 0, 0, 0, 0, 0, 0, 0,10,11,11,12 ],
        [ 0, 0, 0, 0, 0, 0, 0, 0, 0, 0, 0, 0, 0, 0, 0, 0, 0, 0, 0 ],
        [ 0, 0, 0, 0, 0, 0, 0, 0, 0, 0, 0, 0, 0, 0, 0, 0, 0, 0, 0 ],
        [ 0, 0, 0, 0, 0, 0, 0, 0, 0, 0, 0, 0, 0, 0, 0, 0, 0, 0, 0 ],
        [ 0, 0, 0, 0, 0, 0, 0, 0, 0, 0, 0, 0, 0, 0, 0, 0, 0, 0, 0 ],
        [ 0, 0, 0, 0, 0, 0, 0, 0, 0, 0, 0, 0, 0, 0, 0, 0, 0, 0, 0 ],
        [ 0, 0, 0, 0, 0, 0, 0, 0, 0, 0, 0, 0, 0, 0, 0, 0, 0, 0, 0 ],
        [ 0, 0, 0, 0, 0, 0, 0, 0, 0, 0, 0, 0, 0, 0, 0, 0, 0, 0, 0 ],
        [ 0, 0, 0, 0, 0, 0, 0, 0, 0, 0, 0, 0, 0, 0, 0, 0, 0, 0, 0 ],
        [ 0, 0, 0, 0, 0, 0, 0, 0, 0, 0, 0, 0, 0, 0, 0, 0, 0, 0, 0 ],
        [10,42,12, 0, 0, 0, 0, 0, 0, 0, 0, 0, 0, 0, 0, 0, 0, 0, 0 ],
        [ 0, 0, 0, 0, 0, 0, 0, 0, 0, 0, 0, 0, 0, 0, 0, 0, 0, 0, 0 ],
        [ 0, 0, 0, 0, 0, 0, 0, 0, 0, 0, 0, 0, 0, 0, 0, 0, 0, 0, 0 ],
        [ 0, 0, 0, 0, 0, 0, 0, 0, 0, 0, 0, 0, 0, 0, 0, 0, 0, 0, 0 ],
        [ 0, 0, 0, 0, 0, 0, 0, 0, 0, 0, 0, 0, 0, 0, 0, 0, 0, 0, 0 ],
        [ 0, 0, 0, 0, 0, 0, 0, 0, 0, 0, 0, 0, 0, 0, 0, 0, 0, 0, 0 ],
        [ 0, 0, 0, 0, 0, 0, 0, 0, 0, 0, 0, 0, 0, 0, 0, 0, 0, 0, 0 ],
        [ 0, 0, 0, 0, 0, 0, 0, 0, 0, 0, 0, 0, 0, 0, 0, 0, 0, 0, 0 ]
      ]
    },
        {
      "feild": [
        [ 0,20,21,22, 0, 0, 0,20,21,22, 0, 0, 0, 0, 0, 0, 0, 0, 0 ],
        [ 0,23, 5,60,66,66,66,61, 5,25, 0, 0, 0, 0, 0,20,21,21,22 ],
        [ 0,23, 5,62,67,67,67,63, 5,25, 0, 0, 0, 0, 0,23, 5, 5,25 ],
        [ 0,23, 5,64,68,68,68,65, 5,25, 0, 0, 0, 0, 0,32, 5, 5,25 ],
        [ 0,26, 5,28, 0, 0, 0,26, 5,28, 0, 0, 0, 0, 0,33, 5, 5,25 ],
        [ 0, 0, 0, 0, 0, 0, 0, 0, 0, 0, 0, 0, 0, 0, 0,26,27,27,28 ],
        [ 0, 0, 0, 0, 0, 0, 0, 0, 0, 0, 0, 0, 0, 0, 0, 0, 0, 0, 0 ],
        [ 0, 0, 0, 0, 0, 0, 0, 0, 0, 0, 0, 0, 0, 0, 0, 0, 0, 0, 0 ],
        [ 0, 0, 0, 0, 0, 0, 0, 0, 0, 0, 0, 0, 0, 0, 0, 0, 0, 0, 0 ],
        [ 0, 0, 0, 0, 0, 0, 0, 0, 0, 0, 0, 0, 0, 0, 0, 0, 0, 0, 0 ],
        [ 0, 0, 0, 0, 0, 0, 0, 0, 0, 0, 0, 0, 0, 0, 0, 0, 0, 0, 0 ],
        [ 0, 0, 0, 0, 0, 0, 0, 0, 0, 0, 0, 0, 0, 0, 0, 0, 0, 0, 0 ],
        [ 0, 0, 0, 0, 0, 0, 0, 0, 0, 0, 0, 0, 0, 0, 0, 0, 0, 0, 0 ],
        [ 0, 0, 0, 0, 0, 0, 0, 0, 0, 0, 0, 0, 0, 0, 0, 0, 0, 0, 0 ],
        [20,21,22, 0, 0, 0, 0, 0, 0, 0, 0, 0, 0, 0, 0, 0, 0, 0, 0 ],
        [26, 5,28, 0, 0, 0, 0, 0, 0, 0, 0, 0, 0, 0, 0, 0, 0, 0, 0 ],
        [ 0, 0, 0, 0, 0, 0, 0, 0, 0, 0, 0, 0, 0, 0, 0, 0, 0, 0, 0 ],
        [ 0, 0, 0, 0, 0, 0, 0, 0, 0, 0, 0, 0, 0, 0, 0, 0, 0, 0, 0 ],
        [ 0, 0, 0, 0, 0, 0, 0, 0, 0, 0, 0, 0, 0, 0, 0, 0, 0, 0, 0 ],
        [ 0, 0, 0, 0, 0, 0, 0, 0, 0, 0, 0, 0, 0, 0, 0, 0, 0, 0, 0 ],
        [ 0, 0, 0, 0, 0, 0, 0, 0, 0, 0, 0, 0, 0, 0, 0, 0, 0, 0, 0 ],
        [ 0, 0, 0, 0, 0, 0, 0, 0, 0, 0, 0, 0, 0, 0, 0, 0, 0, 0, 0 ],
        [ 0, 0, 0, 0, 0, 0, 0, 0, 0, 0, 0, 0, 0, 0, 0, 0, 0, 0, 0 ],
        [ 0, 0, 0, 0, 0, 0, 0, 0, 0, 0, 0, 0, 0, 0, 0, 0, 0, 0, 0 ]
      ]
    }
  ],
  "chip": {
    "1":  {"cell": "grass/grass1" },
    "2":  {"cell": "grass/grass2" },
    "3": { "cell": "grass/grass3" },
    "4": { "cell": "grass/grassGrow", "encount": "grass" },
    "5": { "cell": "sand/sand" },
    "6": { "cell": "water/water" },
    "7": { "cell": "water/spWater" },
    "8": { "cell": "water/concave" },
    "9": { "cell": "sand/sand", "drawOffsetHeight": -1},
    "10": {"cell": "cliff/vertical/cliffV-LC" },
    "11": {"cell": "cliff/vertical/cliffV-CC" },
    "12": {"cell": "cliff/vertical/cliffV-RC" },
    "13": {"cell": "cliff/vertical/cliffV-LB" },
    "14": {"cell": "cliff/vertical/cliffV-CB" },
    "15": {"cell": "cliff/vertical/cliffV-RB" },
    "20": {"cell": "cliff/top/cliffT-LU" },
    "21": {"cell": "cliff/top/cliffT-CU" },
    "22": {"cell": "cliff/top/cliffT-RU" },
    "23": {"cell": "cliff/top/cliffT-LC" },
    "25": {"cell": "cliff/top/cliffT-RC" },
    "26": {"cell": "cliff/top/cliffT-LB" },
    "27": {"cell": "cliff/top/cliffT-CB" },
    "28": {"cell": "cliff/top/cliffT-RB" },
    "30": {"cell": "cliff/slope/cliffSlopeRU-U" },
    "31": {"cell": "cliff/slope/cliffSlopeRU-B" },
    "32": {"cell": "cliff/slope/cliffSlopeRU-TU" , "drawOffsetHeight": -1},
    "33": {"cell": "cliff/slope/cliffSlopeRU-TB"},
    "34": {"cell": "cliff/slope/cliffSlopeLU-U" },
    "35": {"cell": "cliff/slope/cliffSlopeLU-B" },
    "36": {"cell": "cliff/slope/cliffSlopeLU-TU" , "drawOffsetHeight": -1},
    "37": {"cell": "cliff/slope/cliffSlopeLU-TB" },
    "38": {"cell": "cliff/slope/cliffSlopeDU-L" },
    "39": {"cell": "cliff/slope/cliffSlopeDU-R" },
    "40": {"cell": "cliff/slope/cliffSlopeDU-TL" },
    "41": {"cell": "cliff/slope/cliffSlopeDU-TR" },
    "42": {"cell": "cliff/slope/stepC" },
    "43": {"cell": "cliff/caveEntrance" },
    "50": { "cell": "cliff/slope/cliffSlopeRU-C" },
    "60": { "cell": "bridge/bridgePole0" },
    "61": { "cell": "bridge/bridgePole1" },
    "62": { "cell": "bridge/bridgePole2" },
    "63": { "cell": "bridge/bridgePole3" },
    "64": { "cell": "bridge/bridgePole4" },
    "65": { "cell": "bridge/bridgePole5" },
    "66": { "cell": "bridge/bridge0" },
    "67": { "cell": "bridge/bridge1" },
    "68": { "cell": "bridge/bridge2" }
  },
  "shadow": [
    {"sprite": "cell/bridge/bridge1","collider": "<box,1,1>","position": [Vector3(3,20,0),Vector3(4,20,0),Vector3(5,20,0),Vector3(6,20,0),Vector3(7,20,0)],"offset": Vector2(0.05,0)},
    {"sprite": "cell/bridge/bridge3","collider": "<box,1,1>","position": [Vector3(3,19,0),Vector3(4,19,0),Vector3(5,19,0),Vector3(6,19,0),Vector3(7,19,0)],"offset": Vector2(0.05,0)},
    {"sprite": "cell/bridge/bridge5","collider": "<box,1,1>","position": [Vector3(3,18,0),Vector3(4,18,0),Vector3(5,18,0),Vector3(6,18,0),Vector3(7,18,0)],"offset": Vector2(0.05,0)}
  ],
  "ornament":[ 
  {"path": "sign/treeSign","name": "testSign","x": 6,"y": 1,"height": 0},
  {"path": "sign/treeSign","name": "testSign","x": 0,"y": 9.3,"height": 2},
  {"path": "sign/treeSign","name": "testSign","x": 5,"y": 19,"height": 0},
  {"path": "streetLight","name": "light","x": 6,"y": 3.2,"height": 0},
  {"path": "vase","name": "vase","x": 8,"y": 7,"height": 1}
  ],
  "npc": [
    {"path": "player/player","name": "player","direction": Vector2(1,0),"ai": "<player>","x":4,"y": 2,"height": 0},
    {"path": "player/player","name": "keyboard","direction": Vector2(-1,0),"ai": "<keyboard>","x":7,"y": 12,"height": 1},
    {"path": "player/player","name": "testNpc","direction": Vector2(-1,0),"ai": "<walkAroundCircle,1>","x":10,"y": 6,"height": 1}
  ],
  "trigger": [
    {"name": "test","shape": "<square,1,1>","x":3,"y": 4,"stratum": 2}
  ],
  "event": {
    
  }
}
